000000000000000000000000000000000000000000000000000000000000
000000000000000000000000000000000000000000000000000000000000
000000000000000000000000000000000000000000000000000000000000
00R000000000000000000000000000000000000000000000000000R00000
000000000000000000000000000000000000000000000000000000000R00
009990000000500000000000222222000000500000005000000000999000
99999000000000000000002211CC11220000000000000000000000999999
9BBBD000000000000000030CCCCCCCCC0000000000000000000000DBBBBD
9BBB00000000000000000000CCCCCCCC00000000000000000000000BBBB0
999992222222222222222222222222222222222222222222222222999999