000000000000000000000000000000000000000000000000000000000000
000000000000000000000000000000000000000000000000000000000000
000000000000000000000000000000000000000000000000000000000000
R000000000000000000000000000000000000000000000000000000000000
000R00000000000000000000000000000000000000000000000000000000
999000000050000000000000000000000005000000005000003030303030
999999000000000000000000000000000000000000000000033030303011
DBBBBD000000000000000000000000000000000000000000000303111111
0BBBB0000000000400040000040400400000000400000000011111111111
999999222222222222222222222222222222222222222211111111111111