000000000000000000000000000000000000000000000000000000000000
000000000000000000000000000000000000000000000000000000000000
000000000000000000000000000000000000000000000000000000000000
000000000000000000000000000000000000000000000000003030301030
000000000000000000000000000000000000000000000000000000001100
000000000500000000000000000000500000000000005000001111111111
0000000000000000000000000000000000000000000000000000CCCC1111
06000000000000300000060000000000000000600000000000000CCC1111
00000000000000000004000000000000070000004000400000000CCC1111
122CCCC22222222222222222222222222222222222222222222222222222
000111100000000000000000000000000000000000000000000000000000