R00000000000000000000000000000000000000000000000000000000000
000R00000000000000000000000000000000000000000000000000000000
999000000050000000005000000050000000030303030300000000000050
999999000000000000000000000000000000330303030110000000000000
DBBBBD000000000000000000000000000000003031111110006000000000
0BBBB0000000000400040000040000400000111111CC1111100000000000
9BB99922222222222222222222222222211111CCCCCCCCC11122CCCC2222
1CCCCCCCCCCCCCCCCCCCCCCCCCCCCCCCCCCCCCCCCCCCCCCCCCCCCCC11111
1CCCCCCCCCCCCCCCCCCCCCCCCCCCCCCCCCCCCCCCCCCCCCCCCCCCCC111111
111111111111111111222211111122111111111111122211111111111111